U...........
.P.T........
.........P..
.d....P.....
...P......D.
T.....U.....
....D....P..
..O....U....
...O........
..P...T...P.
.O..P....d..
.........T..